άνθρωπος	человек
ζωή	жизнь
πόλη	город
παιδί	ребенок
ημέρα	день
ώρα	час
σπίτι	дом
δέντρο	дерево
νερό	вода
ήλιος	солнце
βουνό	гора
θάλασσα	море
δρόμος	дорога
αέρας	воздух
χέρι	рука
πόδι	нога
μάτι	глаз
στόμα	рот
αυτί	ухо
σκύλος	собака
γάτα	кошка
πουλί	птица
άλογο	лошадь
ψάρι	рыба
λουλούδι	цветок
βιβλίο	книга
χάρτης	карта
σχολείο	школа
δάσκαλος	учитель
μαθητής	ученик
τσάντα	сумка
αυτοκίνητο	автомобиль
ποδήλατο	велосипед
πλοίο	корабль
αεροπλάνο	самолет
τηλεόραση	телевизор
κινητό	мобильный телефон
υπολογιστής	компьютер
εργασία	работа
χρήματα	деньги
αγάπη	любовь
μίσος	ненависть
χαρά	радость
λύπη	грусть
φόβος	страх
θάρρος	смелость
νίκη	победа
ήττα	поражение
τύχη	удача
πόνος	боль
υγεία	здоровье
φαγητό	еда
νεαρός	молодой
γέρος	старый
όμορφος	красивый
άσχημος	некрасивый
δυνατός	сильный
αδύναμος	слабый
έξυπνος	умный
χαζός	глупый
αστείο	смешной
σοβαρός	серьезный
σιωπηλός	тихий
θορυβώδης	шумный
ζεστός	теплый
κρύος	холодный
βαρύς	тяжелый
ελαφρύς	легкий
γλυκός	сладкий
πικρός	горький
ξινός	кислый
αλμυρός	соленый
πλούσιος	богатый
φτωχός	бедный
γρήγορος	быстрый
αργός	медленный
ψηλός	высокий
κοντός	низкий
νέος	новый
παλιός	старый
καθαρός	чистый
βρώμικος	грязный
ανοιχτός	открытый
κλειστός	закрытый
ζωντανός	живой
νεκρός	мертвый
φυσικός	физический
χημικός	химический
μαθηματικός	математический
κοινωνικός	социальный
πολιτικός	политический
θρησκευτικός	религиозный
οικονομικός	экономический
τεχνικός	технический
ιατρικός	медицинский
καλλιτεχνικός	художественный
στρατιωτικός	военный
νομικός	юридический
εκπαιδευτικός	образовательный
ιστορικός	исторический
φυσιολογικός	физиологический
πολιτισμός	культура
έθνος	народ
κυβέρνηση	правительство
ελευθερία	свобода
δικαιοσύνη	справедливость
ειρήνη	мир
πόλεμος	война
ήρωας	герой
στρατός	армия
μάχη	битва
στρατηγός	генерал
ναύτης	моряк
υπαίθριος	открытый
ευτυχία	счастье
λύση	решение
πρόβλημα	проблема
ερώτηση	вопрос
απάντηση	ответ
γνώση	знание
πληροφορία	информация
δεδομένα	данные
βιβλιοθήκη	библиотека
γραφή	письмо
λέξη	слово
πρόταση	предложение
ιδέα	идея
σκέψη	мысль
όνειρο	мечта
πραγματικότητα	реальность
όραμα	видение
στόχος	цель
επιτυχία	успех
αποτυχία	неудача
αγώνας	борьба
προσπάθεια	попытка
αποτέλεσμα	результат
εξέλιξη	развитие
αρχή	начало
τέλος	конец
στιγμή	момент
μήνας	месяц
χρονιά	год
αιώνας	век
χιλιετία	тысячелетие
παρελθόν	прошлое
παρόν	настоящее
μέλλον	будущее
σήμερα	сегодня
αύριο	завтра
χθες	вчера
καιρός	погода
θύελλα	буря
καταιγίδα	гроза
βροχή	дождь
χιόνι	снег
σύννεφο	облако
αστέρι	звезда
φεγγάρι	луна
ουρανός	небо
γη	земля
ποτάμι	река
λίμνη	озеро
παραλία	пляж
δάσος	лес
ζώο	животное
φυτό	растение
καρπός	фрукт
σπόρος	семя
φύλλο	лист
κλαδί	ветка
ρίζα	корень
καρκίνος	рак
καλημέρα	доброе утро
καλησπέρα	добрый вечер
καληνύχτα	спокойной ночи
συγγνώμη	извините
ευχαριστώ	спасибо
παρακαλώ	пожалуйста
καλή τύχη	удачи
καλώς ήρθατε	добро пожаловать
αντίο	до свидания
ευτυχισμένο	счастливого
κακός	плохой
καλός	хороший
μεγάλος	большой
μικρός	маленький
παχύς	толстый
αδύνατος	худой
ομορφιά	красота
καλοσύνη	доброта
δύναμη	сила
αλήθεια	правда
ψέμα	ложь
φωνή	голос
ήχος	звук
εικόνα	изображение
χρώμα	цвет
φως	свет
σκοτάδι	тьма
θερμότητα	тепло
ψύχος	холод
κρύο	холодный
ζέστη	жара
θερμοκρασία	температура
φωτιά	огонь
χώμα	земля
πέτρα	камень
άμμος	песок
χώρος	пространство
τόπος	место
αθλητισμός	спорт
ποδόσφαιρο	футбол
μπάσκετ	баскетбол
τένις	теннис
βόλεϊ	волейбол
γκολ	гол
παίκτης	игрок
προπονητής	тренер
ομάδα	команда
σκορ	счёт
πρωτάθλημα	чемпионат
αθλητής	спортсмен
διακοπές	отпуск
ταξίδι	путешествие
τουρισμός	туризм
ξενοδοχείο	отель
εστιατόριο	ресторан
καφές	кофе
τσάι	чай
κρασί	вино
μπύρα	пиво
τυρί	сыр
ψωμί	хлеб
αυγό	яйцо
κρέας	мясо
λαχανικά	овощи
φρούτα	фрукты
γάλα	молоко
χυμός	сок
σοκολάτα	шоколад
γλυκό	десерт
ελιά	оливка
αλάτι	соль
πιπέρι	перец
λάδι	масло
βούτυρο	сливочное масло
ζάχαρη	сахар
αλεύρι	мука
μαγειρική	кулинария
συνταγή	рецепт
μαγείρεμα	готовка
κατσαρόλα	кастрюля
τηγάνι	сковорода
κουτάλι	ложка
πιρούνι	вилка
μαχαίρι	нож
πιάτο	тарелка
ποτήρι	стакан
φλυτζάνι	чашка
παγωτό	мороженое
καραμέλα	карамель
γεύση	вкус
κόκκινος	красный
μπλε	синий
πράσινος	зелёный
κίτρινος	жёлтый
μαύρος	чёрный
άσπρος	белый
πορτοκαλί	оранжевый
ροζ	розовый
γκρι	серый
καφέ	коричневый
χρυσός	золотой
ασημένιος	серебряный
φωτεινός	яркий
σκοτεινός	тёмный
βαρετός	скучный
ενδιαφέρον	интересный
λεπτός	тонкий
χοντρός	толстый
άρρωστος	больной
υγιής	здоровый
θεραπεία	лечение
φάρμακο	лекарство
γιατρός	врач
νοσοκομείο	больница
ασθενοφόρο	скорая помощь
πόνους	боль
κακοήθεια	злоба
εγχείρηση	операция
εξέταση	обследование
διάγνωση	диагноз
συμπτώματα	симптомы
κουράγιο	мужество
υπομονή	терпение
ευτυχισμένος	счастливый
δυστυχισμένος	несчастный
ελπίδα	надежда
απογοήτευση	разочарование
θυμός	гнев
ντροπή	стыд
ανησυχία	беспокойство
αγωνία	тревога
άγχος	стресс
ψυχική υγεία	психическое здоровье
προσφορά	предложение
ανταγωνισμός	конкуренция
συνεργασία	сотрудничество
βοήθεια	помощь
παρατήρηση	наблюдение
ψυχολογία	психология
φιλοσοφία	философия
ιστορία	история
γεωγραφία	география
φυσική	физика
χημεία	химия
μαθηματικά	математика
λογοτεχνία	литература
τέχνη	искусство
μουσική	музыка
κινηματογράφος	кино
θεατρική τέχνη	театр
χορός	танец
ζωγραφική	живопись
γλυπτική	скульптура
φωτογραφία	фотография
σχεδίαση	дизайн
αρχιτεκτονική	архитектура
οικολογία	экология
τεχνολογία	технология
πρόγραμμα	программа
ιστοσελίδα	вебсайт
εφαρμογή	приложение
ηλεκτρονικό	электронный
δίκτυο	сеть
πληροφορίες	информация
συνδρομή	подписка
λογαριασμός	счёт
ασφάλεια	безопасность
κίνδυνος	опасность
προστασία	защита
αποθήκη	склад
διανομή	распределение
παραγωγή	производство
εργοστάσιο	фабрика
εταιρεία	компания
επιχείρηση	бизнес
κέρδος	прибыль
ζημία	убыток
χρηματοδότηση	финансирование
αγοραστής	покупатель
πωλητής	продавец
καταναλωτής	потребитель
αγορά	рынок
πώληση	продажа
ζήτηση	спрос
τιμή	цена
αγοράκι	магазин
εμπόριο	торговля
εμπορικός	коммерческий
υπηρεσία	услуга
απόδοση	производительность
ποιότητα	качество
εγγύηση	гарантия
πλεονέκτημα	преимущество
μειονέκτημα	недостаток
ανταμοιβή	вознаграждение
εξυπηρέτηση	обслуживание
εμπειρία	опыт
εκπαίδευση	образование
κατάρτιση	обучение
εργαστήριο	лаборатория
σεμινάριο	семинар
συνέδριο	конференция
σύμβουλος	консультант
υπεύθυνος	ответственный
βοηθός	ассистент
συνεργάτης	партнёр
διευθυντής	директор
εργάτης	рабочий
εργαζόμενος	сотрудник
υπάλληλος	служащий
προσόν	квалификация
ικανότητα	способность
ταλέντο	талант
δεξιότητα	умение
ευκαιρία	возможность
προοπτική	перспектива
σκοπός	задача
σχέδιο	план
επίτευγμα	достижение
αποφάσεις	решения
ευθύνη	ответственность
εξουσία	власть
εξουσιοδότηση	полномочие
διαχείριση	управление
επικοινωνία	коммуникация
στρατηγική	стратегия
τακτική	тактика
ανάλυση	анализ
έρευνα	исследование
αξιολόγηση	оценка
έλεγχος	контроль
συντονισμός	координация
ανάπτυξη	развитие
πρόοδος	прогресс
καινοτομία	инновация
υποδομή	инфраструктура
βελτίωση	улучшение
παρακολούθηση	наблюдение
υποστήριξη	поддержка
ενίσχυση	усиление
συμμαχία	альянс
αντίπαλος	соперник
ανταγωνιστής	конкурент
φορέας	организация
ηγέτης	лидер
πρωτοβουλία	инициатива
αλλαγή	изменение
μεταρρύθμιση	реформа
μεταφορά	передача
παραχώρηση	уступка
επιχορήγηση	грант
επένδυση	инвестиция
αγοραπωλησία	купля-продажа
προμηθευτής	поставщик
προϊόν	продукт
λιανική	розничная
χονδρική	оптовая
αποστολή	доставка
παραγγελία	заказ
παραλαβή	получение
αποζημίωση	компенсация
πληρωμή	оплата
εισπράξεις	доходы
έξοδα	расходы
φορολογία	налоги
φορολογική	налоговый
αναφορά	отчёт
συσκευή	устройство
ιστότοπος	сайт
λογισμικό	программное обеспечение
επιβεβαίωση	подтверждение
σύνδεση	связь
διαδίκτυο	интернет
δικτύωση	сетевое соединение
σύστημα	система
πλατφόρμα	платформа
κώδικας	код
λειτουργία	функция