ψάξω|созависимая форма от ψάχνω (искать)
μιλήσω|созависимая форма от μιλάω (говорить)
πάω|созависимая форма от πηγαίνω (идти, ехать)
δω|созависимая форма от βλέπω (видеть)
έρθω|созависимая форма от έρχομαι (приходить)
γράψω|созависимая форма от γράφω (писать)
διαβάσω|созависимая форма от διαβάζω (читать)
μάθω|созависимая форма от μαθαίνω (учить, узнавать)
τρέξω|созависимая форма от τρέχω (бежать)
κοιμηθώ|созависимая форма от κοιμάμαι (спать)
φάω|созависимая форма от τρώω (есть)
πιω|созависимая форма от πίνω (пить)
αγοράσω|созависимая форма от αγοράζω (покупать)
πουλήσω|созависимая форма от πουλάω (продавать)
ξεκινήσω|созависимая форма от ξεκινάω (начинать)
κοιτάξω|созависимая форма от κοιτάζω (смотреть)
ακούσω|созависимая форма от ακούω (слушать)
ταξιδέψω|созависимая форма от ταξιδεύω (путешествовать)
κολυμπήσω|созависимая форма от κολυμπάω (плавать)
μείνω|созависимая форма от μένω (оставаться)
κάτσω|созависимая форма от κάθομαι (сидеть)
γίνω|созависимая форма от γίνομαι (становиться)
ρωτήσω|созависимая форма от ρωτάω (спрашивать)
απαντήσω|созависимая форма от απαντάω (отвечать)
δώσω|созависимая форма от δίνω (давать)
πάρω|созависимая форма от παίρνω (брать)
ανοίξω|созависимая форма от ανοίγω (открывать)
κλείσω|созависимая форма от κλείνω (закрывать)
θυμηθώ|созависимая форма от θυμάμαι (помнить)
ξεχάσω|созависимая форма от ξεχνάω (забывать)
ζητήσω|созависимая форма от ζητάω (просить)
περάσω|созависимая форма от περνάω (проходить)
φτιάξω|созависимая форма от φτιάχνω (готовить, делать)
καθαρίσω|созависимая форма от καθαρίζω (убирать, чистить)
πληρώσω|созависимая форма от πληρώνω (платить)
κερδίσω|созависимая форма от κερδίζω (выигрывать)
χάσω|созависимая форма от χάνω (терять)
πετάξω|созависимая форма от πετάω (летать)
γιορτάσω|созависимая форма от γιορτάζω (праздновать)
σκέφτομαι|созависимая форма от σκέφτομαι (думать)
δουλέψω|созависимая форма от δουλεύω (работать)
συναντήσω|созависимая форма от συναντώ (встречать)
περιμένω|созависимая форма от περιμένω (ждать)
